CDF.......FDC
.............
....ADGDA....
...B.....B...
..C...F...C..
.D...EGE...D.
.A....F....A.
..C.......C..
...BABABAB...
.D.........D.
.DD.......DD.
.FGFGFGFGFGF.
.............
.....FEF.....