G............
......D......
.....DDD.....
.....DDD.....
....DDDDD....
....DDDDD....
...DDDDDDD...
...DDDDDDD...
......A......
BB.FF.A.DD.EE
BB.FF.A.DD.EE
.............
AAAAAAAAAAAAA
AAAAAAAAAAAAA
AAAAAAAAAAAAA
