.............
.............
..AAAA..AAAA.
..B........B.
..G........G.
..B........B.
..C..FBBF..C.
..B........B.
..G........G.
..B........B.
..AAAAAAAAAA.
..GGGGGGGGGG.
.............
.............