.............
.............
..AA.....AA..
.............
.....BBB.....
.............
..AAAAAAAAA..
.............
.............
.............
.............
.............
.............
...........A.
.............
.............