......G......
.....GFG.....
....GFEFG....
...GFEDEFG...
..GFEDCDEFG..
.GFEDCBCDEFG.
GFEDCBABCDEFG
GFEDCBABGCEFG
.GFEDCBCDEFG.
..GFEDCDEFG..
...GFEDEFG...
....GFEFG....
.....GFG.....
......G......